ankle => el tobillo
arm => el brazo
armpit => la axila
back => la espalda
backbone => el espinazo
beard => la barba
belly => el vientre
blood => la sangre
body => el cuerpo
bone => el hueso
brain => el cerebro
cheek => la mejilla
chest => el pecho
ear => la oreja
elbow => el codo
eye => el ojo
eyebrow => la ceja
eyelash => la pestaña
face => la cara
finger => el dedo
fist => el puño
foot => el pie
forefinger => el índice
forehead => la frente
hair => el pelo
hand => la mano
head => la cabeza
heart => el corazón
heel => el talón
hips => la cadera
intestines => el intestino
kidney => el riñón
knee => la rodilla
leg => la pierna
lips => los labios
little finger => el dedillo
liver => el hígado
lung => el pulmón
moustache => el bigote
mouth => la boca
muscle => el músculo
nail => la uña
neck => el cuello
nerve => el nervio
nose => la nariz
occiput => la nuca
organ => el órgano
palm => la palma
ring finger => el dedo anular
shoulder => el hombro
skeleton => el esqueleto
skin => la piel
skull => el cráneo
sole => la planta
stomach => el estómago
temple => la sien
thigh => el muslo
throat => la garganta
thumb => el pulgar
toe => el dedo del pie
tongue => la lengua
tooth => el diente
waist => la cintura
womb => el útero
wrist => la muñeca

