father => el padre
mother => la madre
parents => los padres
brother => el hermano
sister => la hermana
son => el hijo
daughter => la hija
grandfather => el abuelo
grandmother => la abuela
grandparents => los abuelos
grandchildren => los nietos
uncle => el tío
aunt => la tía
nephew => el sobrino
niece => la sobrina
husband => el marido
wife => la mujer
fiancé => el novio
fiancée => la novia
stepfather => el padrastro
stepmother => la madrastra
cousin (m) => el primo
cousin (f) => la primo
bother-in-law => el hermano político
sister-in-law => la hermana política
father-in-law => el padre político
mother-in-law => la madre política
child (m) => el niño
child (f) => la niña
baby (m) => el bebé
baby (f) => la bebé
