Countries	Nchi
Australia	Australia
Cambodia	Cambodia
Canada	Canada
China	Uchina
Egypt	Misri
England	Uingereza
France	Ufaransa
Germany	Ujerumani
Greece	ugiriki
India	Bara Hindi
Indonesia	Indonesia
Italy	Italia
Japan	Japan
Mexico	Mexico
Morocco	Morocco
Peru	Peru
Spain	Hispania
Thailand	Thailand
USA	Merikani

