qualities	sifa
bad	mbaya
clean	safi
dark	giza
difficult	Ngumu
dirty	chafu
dry	kavu
easy	rahisi
empty	tupu
expensive	ghali
fast	Haraka
foreign	Geni
full	Jaa
good	Njema
hard	ngumu
heavy	nzito
inexpensive	Bei rahisi
light	Nyepesi
local	Kienyeji
new	Mpya
noisy	kelele
old	zee
powerful	hodari
quiet	tulivu
correct	sahihi
slow	polepole
soft	laini
very	sana
weak	dhaifu
wet	loa
wrong	makosa
young	Ujana
