people	watu
aunt	shangazi
baby	mtoto
brother	ndugu
cousin	binamu
daughter	binti
dentist	daktari wa meno
doctor	daktari
father	baba
grandfather	babu
grandmother	nyanya
husband	mume
mother	mama
nephew	mpwa
niece	mpwa
nurse	muuguzi
policeman	polisi
postman	mtu wa posta
professor	profesa
son	mwana
teacher	mwalimu
uncle	mjomba
wife	mke
