weather	hali ya hewa
bad weather	hewa mbaya
cloudy	mawingu
cold	baridi
cool	poa
foggy	ukungu
hot	moto
nice weather	hewa njema
pouring	mtiririko
rain	mvua
raining	kunyesha
snow	theluji
snowing	kunyesha theluji
ice	barafu
sunny	jua
windy	upepo
spring	majira ya kuchipua
summer	majira ya joto
autumn	majira ya kupukutika
winter	majira ya baridi
