the fork => el tenedor
the spoon => la cuchara
the knife => el cuchillo
the plate => la placa de
the cup => la copa
the glass => el cristal
the napkin => la servilleta
the tablecloth => el mantel
the placemat => el mantel
the salt => la sal
the pepper => el pimiento
the sugar => el azúcar
the milk => la leche
the cream => la crema
the coffee => el café
the tea => el té
the wine => el vino
the steak => el filete
the chicken => el pollo
the fish => los peces
the trout => la trucha
the monkfish => el rape
the salmon => el salmón
the tuna => el atún
the asperagus => los espárragos
the brocolli => el brócoli
the corn => el maíz
the mashed potatoes => el puré de patatas
the french fried potatoes => las papas fritas francés
the shrimp => el camarón
the scallops => las vieiras
the goat cheese => el queso de cabra
