campaign => la campaña
candidate => el candidato
coalition => la coalición
coup => el golpe de Estado
democracy => la democracia
demonstration => la manifestación
demonstrator => el/la manifestante
deputy, representative => el diputado
dictatorship => la dictadura
diplomacy => la diplomacia
elections => las elecciones
electoral => electoral
foreign policy => la política exterior
freedom of speech => la libertad de expresión
government => el gobierno
internal affairs => la política interior
majority => la mayoría
minister => el ministro
ministry => el ministerio
minority => la minoría
movement => el movimiento
opposition => la oposición
parliament => el parlamento
party => el partido
politici => el político
president => el presidente
prime minister => el primer ministro
referendum => el plebiscito/referendo
spokesperson => el/la portavoz
state => el estado
vote => el voto
