alligator	alligator
alligators	alligators
bear	beer
bears	beren
bird	vogel
birds	vogels
bull	stier
bulls	stieren
cat	kat
cats	katten
cow	koe
cows	koeien
deer	hert
many deer	veel herten
dog	hond
dogs	honden
donkey	ezel
donkeys	ezels
eagle	arend/adelaar
eagles	arenden/adelaars
elephant	olifant
elephants	olifanten
giraffe	giraffe
giraffes	giraffen
goat	geit
goats	geiten
horse	paard
horses	paarden
lion	leeuw
lions	leeuwen
monkey	aap
monkeys	apen
mouse	muis
mice	muizen
rabbit	konijn
rabbits	konijnen
snake	slang
snakes	slangen
tiger	tijger
tigers	tijgers
wolf	wolf
wolves	wolven
