qualities	eigenschappen
bad	slecht
clean	schoon
dark	donker
difficult	moeilijk
dirty	vuil
dry	droog
easy	gemakkelijk
empty	leeg
expensive	duur
fast	snel
foreign	buitenlands
full	volledig
good	goed
hard	hard/moeilijk
heavy	zwaar
inexpensive	goedkoop
light	licht
local	lokaal/plaatselijk
new	nieuw
noisy	lawaaierig
old	oud
powerful	krachtig
quiet	rustig/stil
correct	correct
slow	traag/langzaam
soft	zacht
very	zeer/erg
weak	zwak
wet	nat
wrong	verkeerd
young	jong
